############################
#    #                     #
#                          #
#    #       ######        #
#                          #
#     ##########           #
#                          #
############################