############################
#                          #
# ###        ###       #####
# # #        # #       #####
# # #        # #       #####
# # #        # #       #####
#   #          #       #####
############################
